### Western Europe
GER = "countries/WestEuropean.txt" # Germany
FRA = "countries/WestEuropean.txt" # France
SPM = "countries/WestEuropean.txt" # Spain - Monarchist
SPR = "countries/WestEuropean.txt" # Spain - Republic
SPA = "countries/WestEuropean.txt" # Spain - Socialist
SPF = "countries/WestEuropean.txt" # Spain - Falangist
BEL = "countries/WestEuropean.txt" # Belgium
RHI = "countries/WestEuropean.txt" # Rhineland
HOL = "countries/WestEuropean.txt" # Netherlands
ITA = "countries/WestEuropean.txt" # Italy
POR = "countries/WestEuropean.txt" # Portugal
PRR = "countries/WestEuropean.txt" # Portuguese Republic
SWI = "countries/WestEuropean.txt" # Switzerland
SWE = "countries/WestEuropean.txt" # Sweden
AUS = "countries/WestEuropean.txt" # Austria
ASR = "countries/WestEuropean.txt" # Austrian Socialist Republic
IRE = "countries/WestEuropean.txt" # Ireland
KNE = "countries/WestEuropean.txt" # Dutch Exiles
HUN = "countries/WestEuropean.txt" # Hungary
HSR = "countries/WestEuropean.txt" # Hungarian Socialist Republic
SCO = "countries/WestEuropean.txt" # Scotland
WLS = "countries/WestEuropean.txt" # Wales
SAX = "countries/WestEuropean.txt" # Saxony
POM = "countries/WestEuropean.txt" # Pomerainia
SHO = "countries/WestEuropean.txt" # Schleswig-Holstein
BRW = "countries/WestEuropean.txt" # Brandenburg-Westpommern
HAN = "countries/WestEuropean.txt" # Hannover
ERM = "countries/WestEuropean.txt" # Ermland
HES = "countries/WestEuropean.txt" # Hessen
BAW = "countries/WestEuropean.txt" # Baden-Wurtemberg
BAY = "countries/WestEuropean.txt" # Bayern
SIL = "countries/WestEuropean.txt" # Silesia
BRI = "countries/WestEuropean.txt" # Britanny
OCC = "countries/WestEuropean.txt" # Occitania
NRM = "countries/WestEuropean.txt" # Normandy
GRP = "countries/WestEuropean.txt" # German Puppet
NAP = "countries/WestEuropean.txt" # Naples
SIC = "countries/WestEuropean.txt" # Sicily
LOM = "countries/WestEuropean.txt" # Lombardy
PIE = "countries/WestEuropean.txt" # Piedmont
SRV = "countries/WestEuropean.txt" # Venice
ITP = "countries/WestEuropean.txt" # Italian Puppet
UPC = "countries/WestEuropean.txt" # United Provinces of Central Italy
COR = "countries/WestEuropean.txt" # Corsica
SAR = "countries/WestEuropean.txt" # Sardinia
FLA = "countries/WestEuropean.txt" # Flanders
WLL = "countries/WestEuropean.txt" # Wallonia
DEN = "countries/WestEuropean.txt" # Denmark
ICE = "countries/WestEuropean.txt" # Iceland
WGR = "countries/WestEuropean.txt" # West Germany
DDR = "countries/WestEuropean.txt" # East Germany
FRP = "countries/WestEuropean.txt" # French Puppet
FIN = "countries/WestEuropean.txt" # Finland
NOR = "countries/WestEuropean.txt" # Norway
NIR = "countries/WestEuropean.txt" # Northern Ireland
FIC = "countries/WestEuropean.txt" # French Indochina
DEI = "countries/WestEuropean.txt" # Dutch East Indies
LUX = "countries/WestEuropean.txt" # Luxembourg
MLT = "countries/WestEuropean.txt" # Malta

### Eastern European
SOV = "countries/EastEuropean.txt" # Soviet Union
RUS = "countries/EastEuropean.txt" # Russian Republic
POL = "countries/EastEuropean.txt" # Poland
CZE = "countries/EastEuropean.txt" # Czechoslovakia
LIT = "countries/EastEuropean.txt" # Lithuania
LAT = "countries/EastEuropean.txt" # Latvia
EST = "countries/EastEuropean.txt" # Estonia
ROM = "countries/EastEuropean.txt" # Romania
ROR = "countries/EastEuropean.txt" # Romanian Revolt
YUG = "countries/EastEuropean.txt" # Yugoslavia
SER = "countries/EastEuropean.txt" # Serbia
ALB = "countries/EastEuropean.txt" # Albania
BUL = "countries/EastEuropean.txt" # Bulgaria
MNT = "countries/EastEuropean.txt" # Montenegro
GRE = "countries/EastEuropean.txt" # Greece
BLR = "countries/EastEuropean.txt" # Belarus
TRA = "countries/EastEuropean.txt" # Transylvania
CEN = "countries/EastEuropean.txt" # Centroslavia
BOH = "countries/EastEuropean.txt" # Bohemia
MRV = "countries/EastEuropean.txt" # Morovia
SLO = "countries/EastEuropean.txt" # Slovakia
STD = "countries/EastEuropean.txt" # Sudetenland
BOS = "countries/EastEuropean.txt" # Bosnia
VRS = "countries/EastEuropean.txt" # Valkist Russia
CRO = "countries/EastEuropean.txt" # Croatia
UKR = "countries/EastEuropean.txt" # Ukraine
GEO = "countries/EastEuropean.txt" # Georgia
GOR = "countries/EastEuropean.txt" # Mountain Republic
MOL = "countries/EastEuropean.txt" # Moldova
MAC = "countries/EastEuropean.txt" # Macedonia
LMK = "countries/EastEuropean.txt" # Lemko
GRL = "countries/EastEuropean.txt" # Goralenland
SLV = "countries/EastEuropean.txt" # Slovenia
ZSR = "countries/EastEuropean.txt" # Zapadoslavian Socialist Republic
FYR = "countries/EastEuropean.txt" # Fyrom

### North America
USA = "countries/WestEuropean.txt" # United States
NEE = "countries/WestEuropean.txt" # New England
NAR = "countries/WestEuropean.txt" # New American Republic
CLB = "countries/WestEuropean.txt" # Columbia
ORE = "countries/WestEuropean.txt" # Oregon
SNE = "countries/WestEuropean.txt" # Shoshone
SRA = "countries/WestEuropean.txt" # Socialist Republic of America
QUE = "countries/WestEuropean.txt" # Quebec

### South America
MEX = "countries/SouthAmerican.txt" # Mexico
BOL = "countries/SouthAmerican.txt" # Bolivia
BRA = "countries/SouthAmerican.txt" # Brazil
UBR = "countries/SouthAmerican.txt" # Brazil - Socialist
BPS = "countries/SouthAmerican.txt" # Brazil - Reactionary
CHL = "countries/SouthAmerican.txt" # Chile
COL = "countries/SouthAmerican.txt" # Colombia
COS = "countries/SouthAmerican.txt" # Costa Rica
ECU = "countries/SouthAmerican.txt" # Ecuador
ELS = "countries/SouthAmerican.txt" # El Salvador
GUA = "countries/SouthAmerican.txt" # Guatemala
HON = "countries/SouthAmerican.txt" # Honduras
NIC = "countries/SouthAmerican.txt" # Nicaragua
PAN = "countries/SouthAmerican.txt" # Panama
PRU = "countries/SouthAmerican.txt" # Peru
URG = "countries/SouthAmerican.txt" # Uruguay
CUB = "countries/SouthAmerican.txt" # Cuba
DOM = "countries/SouthAmerican.txt" # Dominican Republic
HAI = "countries/SouthAmerican.txt" # Haiti
BAH = "countries/SouthAmerican.txt" # Bahamas
BLZ = "countries/SouthAmerican.txt" # Belize
JAM = "countries/SouthAmerican.txt" # Jamaica
GDL = "countries/SouthAmerican.txt" # Guadaloupe
TRI = "countries/SouthAmerican.txt" # Trinidad and Tobago
PUE = "countries/SouthAmerican.txt" # Puerto Rico
BAS = "countries/SouthAmerican.txt" # British Antilles
ARG = "countries/SouthAmerican.txt" # Argentina
VEN = "countries/SouthAmerican.txt" # Venezuela
PAR = "countries/SouthAmerican.txt" # Paraguay
SUR = "countries/SouthAmerican.txt" # Suriname
CAY = "countries/SouthAmerican.txt" # Cayenne
CRU = "countries/SouthAmerican.txt" # Cruzoob
CRC = "countries/SouthAmerican.txt" # Curacao

### Central Asia
KAZ = "countries/MiddleEastern.txt" # Kazakhstan
TRK = "countries/MiddleEastern.txt" # Turkestan
AZR = "countries/MiddleEastern.txt" # Azerbaijan
ARM = "countries/MiddleEastern.txt" # Armenia
UZB = "countries/MiddleEastern.txt" # Uzbekistan
TAJ = "countries/MiddleEastern.txt" # Tajikistan
KYR = "countries/MiddleEastern.txt" # Kyrgyzstan
DAG = "countries/MiddleEastern.txt" # Dagestan
TMS = "countries/MiddleEastern.txt" # Turkmenistan

### Middle East
TUR = "countries/MiddleEastern.txt" # Turkey
# TRT = "countries/MiddleEastern.txt" # Turkish Revolt
AFG = "countries/MiddleEastern.txt" # Afghanistan
YEM = "countries/MiddleEastern.txt" # Yemen
OMA = "countries/MiddleEastern.txt" # Oman
SAU = "countries/MiddleEastern.txt" # Saudi Arabia
LEB = "countries/MiddleEastern.txt" # Lebanon
EGY = "countries/MiddleEastern.txt" # Egypt
LBA = "countries/MiddleEastern.txt" # Libya
ISR = "countries/MiddleEastern.txt" # Israel
KUR = "countries/MiddleEastern.txt" # Kurdestan
ALG = "countries/MiddleEastern.txt" # Algeria
MOR = "countries/MiddleEastern.txt" # Morocco
TUN = "countries/MiddleEastern.txt" # Tunisia
ARB = "countries/MiddleEastern.txt" # Hashemite Arabia
KUW = "countries/MiddleEastern.txt" # Kuwait
CYP = "countries/MiddleEastern.txt" # Cyprus
IRQ = "countries/MiddleEastern.txt" # Iraq
PER = "countries/MiddleEastern.txt" # Persia
SYR = "countries/MiddleEastern.txt" # Syria
JOR = "countries/MiddleEastern.txt" # Jordan
PHN = "countries/MiddleEastern.txt" # Phoenicia
TRU = "countries/MiddleEastern.txt" # Trucial States
RAS = "countries/MiddleEastern.txt" # Rashidi Arabia

### Asia
PRC = "countries/Asian.txt" # Communist China
PHI = "countries/Asian.txt" # Philippines
SIA = "countries/Asian.txt" # Siam
JAP = "countries/Asian.txt" # Japan
ICR = "countries/Asian.txt" # Indochina
MAN = "countries/Asian.txt" # Manchuria
ZHI = "countries/Asian.txt" # Zhili
CHI = "countries/Asian.txt" # China
YUN = "countries/Asian.txt" # Yunnan
MON = "countries/Asian.txt" # Mongolia
BHU = "countries/Asian.txt" # Bhutan
TIB = "countries/Asian.txt" # Tibet
XSM = "countries/Asian.txt" # Ma Clique
NEP = "countries/Asian.txt" # Nepal
SIK = "countries/Asian.txt" # Xinjiang
KOR = "countries/Asian.txt" # Korea
VIN = "countries/Asian.txt" # Vietnam
LAO = "countries/Asian.txt" # Laos
CAM = "countries/Asian.txt" # Cambodia
MAL = "countries/Asian.txt" # Malaysia
INS = "countries/Asian.txt" # Insulindia
KMT = "countries/Asian.txt" # Jieshi
GUO = "countries/Asian.txt" # Yuxiang
GXC = "countries/Asian.txt" # Zongren
GDC = "countries/Asian.txt" # Jingwei
SHX = "countries/Asian.txt" # Shanxi
TAN = "countries/Asian.txt" # Tannu Tuva
BRM = "countries/Asian.txt" # Burma
SIR = "countries/Asian.txt" # Siamese Rebels
PNG = "countries/Asian.txt" # Papua New Guinea
SCH = "countries/Asian.txt" # Sichuan
MEN = "countries/Asian.txt" # Mengkukuo
NKR = "countries/Asian.txt" # North Korea
SHN = "countries/Asian.txt" # Shan

### South Asia
IND = "countries/Indian.txt" # India
INC = "countries/Indian.txt" # India - Communist
TRV = "countries/Indian.txt" # Travancore
MDR = "countries/Indian.txt" # Madras
HYD = "countries/Indian.txt" # Hyderabad
ORI = "countries/Indian.txt" # Orissa
RJH = "countries/Indian.txt" # Rajahstan
BAL = "countries/Indian.txt" # Baluchistan
PUN = "countries/Indian.txt" # Punjab
KAS = "countries/Indian.txt" # Kashmir
BIH = "countries/Indian.txt" # Bihar
MYS = "countries/Indian.txt" # Mysore
BOM = "countries/Indian.txt" # Bombay
PAK = "countries/Indian.txt" # Pakistan
BAN = "countries/Indian.txt" # Bangladesh
SRL = "countries/Indian.txt" # Sri Lanka
MLD = "countries/Indian.txt" # Maldives
BNG = "countries/Indian.txt" # Bengal

### Commonwealth
ENG = "countries/Commonwealth.txt" # United Kingdom
EGL = "countries/Commonwealth.txt" # England
UOB = "countries/Commonwealth.txt" # Union of Britain
AST = "countries/Commonwealth.txt" # Australia
NZL = "countries/Commonwealth.txt" # New Zealand
NFL = "countries/Commonwealth.txt" # Newfoundland
CAN = "countries/Commonwealth.txt" # Canada
RAJ = "countries/Commonwealth.txt" # British Raj
SAF = "countries/Commonwealth.txt" # South Africa
ZAF = "countries/Commonwealth.txt" # Zuid
BEA = "countries/Commonwealth.txt" # British East Indies

### Africa
DAH = "countries/African.txt" # Dahomey
ANG = "countries/African.txt" # Angola
MZB = "countries/African.txt" # Mozambique
COG = "countries/African.txt" # Congo
KEN = "countries/African.txt" # Kenya
ZIM = "countries/African.txt" # Zimbabwe
BOT = "countries/African.txt" # Botswana
SUD = "countries/African.txt" # Sudan
SOM = "countries/African.txt" # Somalia
NIG = "countries/African.txt" # Nigeria
RHO = "countries/African.txt" # Rhodesia
TAU = "countries/African.txt" # Taureg
ERI = "countries/African.txt" # Eritrea
NFA = "countries/African.txt" # French North Africa
NFQ = "countries/African.txt" # French Central Africa
MAD = "countries/African.txt" # Madagascar
DJI = "countries/African.txt" # Djibouti
UGA = "countries/African.txt" # Uganda
RWA = "countries/African.txt" # Rwanda
BRD = "countries/African.txt" # Burundi
TZN = "countries/African.txt" # Tanzania
ZAM = "countries/African.txt" # Zambia
GAB = "countries/African.txt" # Gabon
EQG = "countries/African.txt" # Equatorial Guinea
CMR = "countries/African.txt" # Cameroon
CAR = "countries/African.txt" # Central African Republic
CHA = "countries/African.txt" # Chad
NGA = "countries/African.txt" # Nigeria
TOG = "countries/African.txt" # Togo
GHA = "countries/African.txt" # Ghana
IVO = "countries/African.txt" # Ivory Coast
VOL = "countries/African.txt" # Upper Volta
MLI = "countries/African.txt" # Mali
SIE = "countries/African.txt" # Sierra Leone
GNA = "countries/African.txt" # Guinea
GNB = "countries/African.txt" # Guinea-Bissau
SEN = "countries/African.txt" # Senegal
GAM = "countries/African.txt" # Gambia
NGR = "countries/African.txt" # Niger
NMB = "countries/African.txt" # Namibia
WES = "countries/African.txt" # Western Sahara
ETH = "countries/African.txt" # Ethiopia
LIB = "countries/African.txt" # Liberia
MRT = "countries/African.txt" # Mauritania

### Ocenia
FIJ = "countries/Indian.txt" # Fiji
GYA = "countries/Indian.txt" # Guyana
HAW = "countries/WestEuropean.txt" # Hawaii

### Others
XXB = "countries/WestEuropean.txt" # GFX TWO?